--*---------*--
--*---------*--
---*-------*---
----*-----*<---
-----*---*-----
------*-*------
-------*-------
------*-*------
-----*---*-<---
----*-----*----
---*-------*---
--*------!--*--
--*---------*--
--*--------*---
---*------*----
--<-*----*-----
-----*--*------
------**-------
------**-------
-----*--*------
----*----*-----
--<*------*----
---*-------*---
--*---------*--
--*---------*--
---*--------*--
----*------*---
-----*----*----
------*--*-----
-------**------
-------**------
---------------
---!---$-------
